ENSG00000046774
ENSG00000068985
ENSG00000070031
ENSG00000082929
ENSG00000095752
ENSG00000099399
ENSG00000099869
ENSG00000101425
ENSG00000101441
ENSG00000102021
ENSG00000102313
ENSG00000105492
ENSG00000107014
ENSG00000107018
ENSG00000109272
ENSG00000111536
ENSG00000116726
ENSG00000117148
ENSG00000120055
ENSG00000120211
ENSG00000122133