ENSG00000177688
ENSG00000182968
ENSG00000185962
ENSG00000196805
ENSG00000203737
ENSG00000205649
ENSG00000205922
ENSG00000123576